8,8,8,8,8,8,8,8,8,8,8,8,8,8,8,8,8,8,8,8,8,8,8,8,8,8,8,8,8,8,8,8,8,8,8,8,8,8,8,8,8,8,8,8,8,8,8,8,8,8,8,8,8,8,8,8,8,8,8,8,8,8,8,8,8,8,8,8,8,8,8,8,8,8,8,8,8
,
8,8,8,8,8,8,8,8,8,8,8,8,8,8,9,9,9,8,8,8,8,8,8,8,8,8,8,8,8,2,2,2,2,2,8,8,8,8,8,8,8,8,8,8,8,8,8,8,8,8,8,8,8,8,8,8,8,8,8,8,8,8,9,9,8,8,8,8,9,1,1,1,1,8,8,8,8
,
8,8,8,8,8,8,8,8,8,8,8,8,8,8,9,9,9,8,8,8,8,8,8,8,8,8,8,8,8,2,2,2,2,2,8,8,8,8,8,8,8,8,8,8,8,8,8,8,8,8,8,8,8,8,8,8,8,8,8,8,8,8,9,9,8,8,8,8,8,8,1,1,8,8,8,8,8
,
8,8,8,8,8,8,8,8,8,8,8,8,8,8,9,9,9,8,8,8,8,8,8,8,8,8,8,8,8,8,9,9,9,8,8,8,8,8,8,8,8,8,8,8,8,8,8,8,8,8,8,8,8,8,8,8,8,8,8,8,8,8,8,9,9,8,8,8,8,8,9,9,8,8,8,8,8
,
8,8,8,8,8,8,8,8,8,8,8,8,8,8,9,9,9,8,8,8,8,8,8,8,8,8,8,8,8,8,9,9,9,8,8,8,8,8,8,8,8,8,8,8,8,8,8,8,8,8,8,8,8,8,8,8,8,8,8,8,8,8,8,8,9,9,9,9,9,9,9,9,8,8,8,8,8
,
8,8,8,8,8,8,8,8,8,8,8,8,8,8,9,9,9,8,8,8,8,8,8,8,8,8,8,9,9,8,9,9,9,9,9,9,8,8,8,8,8,8,8,8,8,8,8,8,8,8,8,8,8,8,8,8,8,8,8,8,8,8,8,8,8,9,9,8,8,8,9,9,8,8,8,8,8
,
8,8,9,9,9,8,8,9,9,9,9,9,9,9,9,9,9,9,9,9,9,9,9,9,9,9,9,9,9,9,9,9,9,9,9,9,9,9,9,9,9,8,8,8,8,8,8,8,8,8,8,8,8,9,9,9,9,9,9,9,9,9,9,9,9,9,9,9,8,8,9,9,8,8,8,8,8
,
8,8,9,9,9,8,9,9,9,9,9,9,9,9,9,9,9,8,8,9,9,9,9,9,9,9,9,9,9,9,9,9,9,9,9,9,9,9,9,9,9,8,8,8,8,8,8,8,8,8,8,8,8,9,8,8,9,9,9,9,9,9,9,9,9,9,9,9,8,8,9,9,8,8,8,8,8
,
8,8,9,9,9,9,9,9,9,9,9,9,9,8,8,8,8,8,8,8,8,8,9,9,9,9,9,9,9,9,9,9,9,8,8,9,9,9,9,9,9,8,8,8,8,8,8,8,8,8,8,8,8,9,8,8,9,9,9,9,9,9,9,9,9,9,9,9,8,8,9,9,8,8,8,8,8
,
8,8,9,9,9,9,9,9,9,9,9,9,9,8,8,8,8,8,8,8,8,8,9,9,9,9,9,9,9,9,9,9,8,8,8,8,8,8,8,8,9,8,9,8,8,8,8,8,8,8,9,9,8,9,9,9,9,9,9,9,9,9,9,9,9,9,9,9,8,8,9,9,8,8,8,8,8
,
8,8,9,9,9,9,9,9,9,9,9,9,8,8,8,8,8,8,8,8,8,8,9,9,9,9,9,9,9,9,9,9,8,8,8,8,8,8,8,8,9,8,9,8,8,9,9,9,9,9,8,9,8,9,9,9,9,9,9,9,9,9,9,9,9,9,9,9,8,8,9,9,8,8,8,8,8
,
8,8,9,9,8,9,9,9,9,9,9,9,8,8,8,8,8,8,8,8,8,8,9,9,9,9,9,9,9,9,8,8,8,8,8,8,8,8,8,8,9,8,9,8,8,9,9,9,9,9,8,9,8,9,9,9,9,9,9,9,9,9,9,9,9,9,9,9,8,8,9,9,8,8,8,8,8
,
8,8,9,9,8,9,9,9,9,9,9,9,8,8,8,8,8,8,8,8,8,8,9,9,9,9,9,9,9,9,8,9,8,8,8,8,8,8,8,8,9,8,9,9,9,9,9,9,9,9,9,9,8,9,9,9,9,9,8,8,8,8,9,9,9,9,9,9,8,8,9,9,8,8,8,8,8
,
8,8,9,9,8,8,8,8,9,9,9,9,8,8,8,8,8,8,8,8,8,8,9,9,9,9,9,9,9,9,8,9,8,8,8,8,8,8,8,8,9,8,8,8,8,9,9,9,9,8,8,8,8,9,9,9,9,9,8,8,8,8,9,9,8,8,9,9,8,8,9,9,9,9,8,8,8
,
8,8,9,9,9,9,9,8,9,9,9,9,8,8,8,8,8,8,8,8,8,8,8,8,8,9,9,9,9,9,8,9,9,9,9,9,9,9,9,9,9,9,9,9,8,9,9,9,9,8,9,9,9,9,9,9,9,9,8,8,8,8,9,8,8,8,8,9,8,8,9,9,9,9,8,8,8
,
8,8,9,9,9,9,9,8,9,9,9,9,9,9,9,9,8,8,8,8,8,8,8,8,8,9,9,9,9,9,8,9,9,9,8,8,8,8,8,9,9,9,8,9,8,9,9,9,9,8,9,9,9,9,9,9,9,9,8,8,8,8,9,8,8,8,8,8,8,8,9,9,9,9,9,9,8
,
8,6,9,9,9,9,9,8,9,9,9,9,9,9,9,9,9,8,9,9,9,8,8,8,8,9,9,9,9,9,8,9,9,9,8,8,8,8,8,9,9,9,8,9,9,9,9,9,9,9,9,9,9,9,9,9,9,9,8,8,8,8,9,8,8,8,8,8,8,8,9,9,9,9,9,9,8
,
8,6,9,9,9,9,9,8,9,9,9,9,9,9,9,9,9,9,9,9,9,8,8,8,8,9,9,9,9,9,8,8,8,8,8,8,8,8,8,9,9,9,9,9,9,9,9,9,9,9,9,9,9,9,9,9,9,9,9,9,9,9,9,8,8,8,8,8,8,8,9,9,9,9,9,9,8
,
8,6,9,9,9,9,9,8,9,9,9,9,9,9,9,9,9,9,9,9,9,8,8,8,8,9,9,9,9,9,9,9,9,9,8,8,8,8,8,9,9,9,9,9,9,9,9,9,9,9,9,9,9,9,9,8,8,8,8,8,8,8,8,8,8,8,8,8,8,8,9,9,8,8,8,8,8
,
8,6,9,9,9,9,9,8,8,8,8,8,9,9,9,9,9,9,9,8,9,9,9,9,9,9,9,9,9,9,9,9,9,9,8,8,8,8,8,9,9,9,9,9,9,9,9,9,9,9,9,9,9,9,9,9,9,9,9,9,9,9,9,9,9,9,8,9,8,8,8,8,8,8,8,8,8
,
8,6,9,9,9,9,9,8,8,8,8,8,9,9,9,9,9,9,9,8,9,9,9,9,9,9,9,9,9,9,9,9,9,9,9,9,9,8,9,9,9,9,9,9,9,9,9,9,9,9,9,9,9,9,9,9,9,9,9,9,9,9,9,9,9,8,8,9,8,8,8,8,8,8,8,8,8
,
8,6,9,9,9,9,9,8,8,8,8,8,9,9,9,9,9,9,9,9,9,9,9,9,9,9,9,9,9,9,9,9,9,9,9,9,9,9,9,9,9,9,9,9,8,8,9,9,9,9,9,9,9,9,9,9,9,9,9,9,9,9,9,9,9,8,8,9,8,8,8,8,8,8,8,8,8
,
8,6,9,9,9,9,9,8,8,8,8,8,9,9,9,9,9,9,9,9,9,9,9,9,9,9,9,9,9,9,9,9,9,9,9,9,9,9,9,9,9,9,9,8,8,8,8,9,9,9,9,8,8,9,9,9,9,9,9,9,9,9,9,9,9,9,8,9,8,8,8,8,8,8,8,8,8
,
8,6,9,9,9,9,9,8,9,8,8,8,9,9,9,9,9,9,9,9,9,9,9,8,8,9,9,9,9,9,9,9,9,9,9,9,9,9,9,9,9,9,9,8,8,8,8,9,9,9,8,8,8,8,9,8,8,8,8,8,9,9,9,9,9,9,9,9,8,8,8,8,8,8,8,8,8
,
8,8,9,9,9,9,9,8,9,8,9,9,9,9,9,9,9,9,9,9,9,9,8,8,8,8,9,9,9,9,9,9,9,9,9,9,9,9,9,9,9,9,9,8,8,8,8,9,9,9,8,8,8,8,9,8,8,8,8,8,9,9,9,9,9,9,9,9,8,8,8,8,8,8,8,8,8
,
8,8,9,9,9,9,9,8,9,9,9,9,9,9,9,9,9,9,9,9,9,9,8,8,8,8,9,9,9,9,9,9,9,9,9,9,9,9,9,9,9,9,9,8,8,8,8,9,9,9,8,8,8,8,9,8,8,8,8,8,9,9,9,9,9,9,9,9,8,8,8,8,8,8,8,8,8
,
8,8,9,9,9,9,9,8,9,9,9,9,9,9,9,9,9,9,9,9,9,9,8,8,8,8,9,9,9,9,9,9,9,9,9,9,9,9,9,9,9,9,9,8,8,8,8,9,9,9,8,8,8,8,9,8,8,8,8,8,9,9,9,9,9,9,9,9,9,8,8,8,8,8,8,8,8
,
8,8,9,9,9,9,9,8,9,9,9,9,9,9,9,9,9,9,8,8,8,8,8,8,8,8,9,9,9,9,9,8,8,8,8,9,9,9,9,9,9,9,9,9,8,9,9,9,9,9,8,8,8,8,9,8,8,8,8,8,9,9,9,9,9,9,9,9,9,9,9,9,5,5,8,8,8
,
8,8,9,9,9,8,8,8,9,9,9,9,9,9,9,9,9,9,8,8,8,8,8,8,8,8,9,9,9,9,9,8,8,8,8,9,9,9,9,9,9,9,9,9,8,8,9,9,9,9,9,9,9,9,9,9,9,9,9,9,9,9,9,9,9,9,9,9,9,9,9,9,9,5,8,8,8
,
8,8,9,9,9,8,8,8,8,8,8,9,9,8,8,9,9,8,8,8,8,8,8,8,8,8,9,9,9,9,9,8,8,8,8,9,9,9,9,9,9,9,9,9,9,8,9,8,8,8,8,9,9,8,8,8,8,9,9,9,9,9,9,9,9,9,9,9,8,8,8,8,8,8,8,8,8
,
8,8,9,9,8,8,8,9,9,9,8,9,9,9,8,9,9,8,8,8,8,8,9,9,9,9,9,8,8,9,9,8,8,8,8,9,9,9,9,9,9,9,9,9,9,9,9,8,8,8,8,9,9,8,8,8,8,9,9,9,9,9,9,9,9,9,9,9,8,8,8,8,8,8,8,8,8
,
8,8,9,9,8,8,8,9,9,9,8,9,9,9,8,9,9,8,8,8,8,8,9,9,9,9,9,8,8,9,9,8,8,8,8,8,8,9,9,9,9,9,9,9,9,9,9,8,8,8,8,9,9,8,8,8,8,9,9,9,8,8,8,8,9,9,9,9,8,8,8,8,8,8,8,8,8
,
8,8,8,9,8,8,8,9,8,9,8,9,9,9,8,9,9,8,9,9,9,9,9,9,9,9,9,9,9,9,9,8,8,8,8,8,8,9,9,9,9,9,9,9,9,9,9,8,8,8,8,9,9,8,8,8,8,9,9,9,8,8,8,8,9,9,9,9,8,8,8,8,8,8,8,8,8
,
8,8,8,8,8,8,8,9,8,9,9,9,9,9,8,9,9,8,8,8,9,8,9,9,9,9,9,9,9,9,9,8,8,8,8,9,8,9,9,9,9,9,9,9,9,9,9,9,9,9,9,9,9,8,8,8,8,9,9,9,8,8,8,8,9,9,9,9,8,8,8,8,8,8,8,8,8
,
8,8,8,8,8,8,8,8,9,9,9,9,9,9,8,9,9,9,9,8,9,8,9,9,9,9,9,9,9,9,9,9,9,9,9,9,9,9,9,9,9,9,9,9,9,9,9,9,9,9,9,9,9,8,8,9,9,9,9,9,9,9,9,9,9,9,9,9,8,8,8,8,8,8,8,8,8
,
8,8,8,8,8,9,8,8,9,9,9,9,9,9,8,9,9,9,9,9,9,9,9,9,9,9,9,9,9,9,9,9,9,9,9,9,9,9,9,9,9,9,9,9,9,9,9,9,9,9,9,9,9,9,9,9,9,9,9,9,9,9,9,9,9,9,9,9,8,8,8,8,8,8,8,8,8
,
8,8,8,8,8,9,8,8,9,9,9,9,9,9,8,8,8,8,8,8,8,8,8,8,8,8,8,8,8,8,8,8,8,8,8,8,8,8,8,8,9,9,8,8,8,8,8,8,8,8,8,8,8,8,8,8,8,8,8,8,8,9,9,9,8,8,9,9,8,8,8,8,8,8,8,8,8
,
8,8,8,8,8,9,9,9,9,9,9,9,9,9,8,8,8,8,8,8,8,8,8,8,8,8,8,8,8,8,8,8,8,9,9,9,9,9,9,8,9,9,8,8,8,8,8,8,8,8,8,8,8,8,8,8,8,8,8,8,8,9,9,9,8,8,9,9,8,8,8,8,8,8,8,8,8
,
8,8,8,8,9,9,9,9,9,8,8,8,9,9,8,8,8,8,8,8,8,8,8,8,8,8,8,8,8,8,8,8,8,8,9,9,9,8,9,9,9,9,8,8,8,8,8,8,8,8,8,8,8,8,8,8,8,8,8,8,8,9,9,9,8,8,9,9,8,8,8,8,8,8,8,8,8
,
8,8,9,9,9,8,8,8,8,8,8,8,9,8,8,8,8,8,8,8,8,8,8,8,8,8,8,8,8,8,8,8,8,8,4,4,8,8,8,8,8,8,8,8,8,8,8,8,8,8,8,8,8,8,8,8,8,8,8,8,8,9,9,9,8,8,9,9,8,8,8,8,8,8,8,8,8
,
8,3,9,9,9,8,8,8,8,8,8,8,8,8,8,8,8,8,8,8,8,8,8,8,8,8,8,8,8,8,8,8,8,8,8,8,8,8,8,8,8,8,8,8,8,8,8,8,8,8,8,8,8,8,8,8,8,8,8,8,8,9,9,9,9,9,9,9,8,8,8,8,8,8,8,8,8
,
8,3,3,9,8,8,8,8,8,8,8,8,8,8,8,8,8,8,8,8,8,8,8,8,8,8,8,8,8,8,8,8,8,8,8,8,8,8,8,8,8,8,8,8,8,8,8,8,8,8,8,8,8,8,8,8,8,8,8,8,8,8,8,8,8,8,8,8,8,8,8,8,8,8,8,8,8
,
8,8,8,8,8,8,8,8,8,8,8,8,8,8,8,8,8,8,8,8,8,8,8,8,8,8,8,8,8,8,8,8,8,8,8,8,8,8,8,8,8,8,8,8,8,8,8,8,8,8,8,8,8,8,8,8,8,8,8,8,8,8,8,8,8,8,8,8,8,8,8,8,8,8,8,8,8
,
